15.*X
.....*..*..*...
.....*..*....**
.....*..*......
*....*..*......
*...**....*....
..*....*.....*.
...*.*....*..**
........*.**...
.*.........*.*.
*.....**.*...*.
*.......*......
...............
.....*.........
...*.....*****.
...**.....*....
