10.*X
...*......
..........
.*.****..*
..*.*....*
..*..*.*.*
.*...***..
***..**.**
.....*...*
******..*.
.*.*.*.*..
