20.*X
*...................
............*.......
......*.*....*...*..
.......*..**........
*...................
..............*..*.*
.*...........**..***
.......*............
.......*.*..........
......*.............
....*...............
......*.**.....****.
*..................*
.*...*..*.**.*.*..*.
*..*....*.*....**...
*...........*.......
...........**.......
.........*.........*
....*.*...*.........
*.*......*..**......
