25.*X
.................*.......
........*.....*...*...*.*
.*............*...*......
...*..*.....*............
....*..........*...*....*
.*...**....**.*....*.....
..*..............*....*..
...*...*......*....**....
.......*.......*.........
.*.......*.........*...*.
........*...*...........*
.....*.........**........
.....*................*.*
.*..*....*...............
................**...*...
.................*.*.....
..........**.......*.....
.........................
.....**......*...**..*..*
.............*.*.........
......**.................
.....**.......*......*...
.............*....*....*.
...*.....*...............
...*.*......*.*..........
