30.*X
...*.....**.**.*.....**.*...*.
**...*.....*....*.*.*......*..
.*...*...*....*...*....*.*....
.....*......*........*.***....
.**.....**.....*.....*.*......
.....*.....*.**.*.*....***..*.
.........**.**..........**...*
.*....**.*.*..*...*..*.**.***.
..**..........*..**....*.*.**.
.....*...*...........*.***....
.**..**..**...*........*..*...
.**.*....*...*.*...***....*..*
..***....***...*...*.**.*...*.
.*........****.....*....**..*.
.*.....*..***.......*.....*...
.*........****.*....*........*
*........*.*.*.........**.....
.......*..*...*..*...*....*...
**..*.*.*..*..*.**.*.*......**
........*....*....*.....*..*.*
***...*..........*....*.**....
.*.*.....*......**......*.....
...*..........*........*......
..***.*......*.**....*.**.*..*
*............*...**..*..**.*.*
....*..*...............*.....*
*....***.**.....**.*.**...*...
***....****...*...***......*.*
**...**..*.**.**.*....*....*..
**.*..***...**.....*.......*.*
