150.*X
.*.....*.*......*.**.***.*..*..*.*......****.....******....*.*.*......**.*.*.**.**...**.*...*......**....*..*..........**..***....*...*...*.....**....
..****..........*.*.*.*.**.........*...*..*.....*..*.*.*.........*.*....*..**..*.*....*.*...*..**......*..**.*.*.............*****.**..*.*....**.****.
.............*..........*.**..*.*..*.*.*.*.........*...*.*.*...***..******.***.*...*.*....**...***....*......*......*.*..**...*.....**..*.**...*.**.*.
.*....*..*.*......**.......*.*..*....*..*..*.**.*....*.**..**..*..*....*.*......*.**.*.*.**....*.*........**.**..*..***...*.*.*.....***.*...***..**...
..*........*.*....*.*..***......****..*...**..*......**.......*...*.*..*..*...******.*....**....***.............**...*.*.....*....**...**...*.*...*.*.
...**..*......*.**....***.**...*...***..*..*..***.....*.*..**..........*.....*..**.*...*.***.....****.....*....*...*....*.*.***.**..*...*....*.*.*..*.
.***..**.......**.......***....*...**.*.....*.**..*.....*.....*....**.*..**.*.*..*****........*..**...**....*....*....**.*......**...**.*.*....*..*..*
..***.*....**..*.......***...***....*......*.....****.....**.*.*..............**.*.................**.....*...*.**...*......*.*..****......*...*.*****
.*...***..**......*.............*.....*..*.*.*...*.*..*.**..*...**..**...**..*.....**.*.....**..*...*..*.........*....*.....*..*.....*.*......*.......
.............**.*.....*....***...**.*...*.....*.**.*.*...*..*.......*..*...*...*......**...*****..*.*.*.**.....*.*.......*..**....*..*.*..*.....*.*...
*.....*........*.......**.*..**.**....*........**......*..**...*.....*...*****...**.........*......*.*..*........*..**...*..*.*....*.......*...**.*...
*.*.*.*.......**....*......*..*.**.**....*.*....**.**.*.....*....*.***....*...*.*..*....*.....***.*...*....**.*..*.**.*.*..*.*..*..*.*........*.*.*...
...*...*.*.....**.*.***.**........*.*....*..***.*...*.**....****.......*......*........*................*..*...**.*.....*....*...*....*.............*.
.*....*...**....*.*..*.*..*...*....*.*.**..*....*..***.*..*.*..*.*.........**.*..*..*....**......**.*.*..********.**.*..*.........................***.
......*.........*....*...*..*.*.*.*.*.*.........*..*.....*.**.*....*.*..*....*...**..***..*.**..**...**.*.....*.*...*.....*........*.**....*.*.....*..
*..........*......***.......**..*.....**......***..**..*.*....***.....***.*....**.**...*..*.*..*...*.*...**.....**.**......*...*...*.**..*..*.*...*.*.
..*...*.**..**....*.*..**.*........**...***........*.*..**.*...*..****..*.....*..*.*..*.*....*.*.*..*.......****................**........***.*...**.*
..**..*****.*...**..*..*.**.........*......*..**.....*..*..**...**.*.**....*.........**.***.*.****.**.....*.*....*..*..*.....**....*....**.*..**.*.**.
.*.*..*........*..*.***...*.**.*...*.......***........**....*.*.............*...**..*....*.*.....*...........................*....***.*...*...*......*
......*.**..*........*.......**.**.......**.*..*...****...........*..*..**....*.*.......*.*.*.*.........**.........**...*.*..*..*.*.*.*.*...*...**..**
..**.*......*..*....**..*.*...*...*.**...**....*.*..*.....*...**.....**.....*...*.....***.*....*.**...*.**..*.*.*.....*.*..*......*........**....**.*.
..*......**.**.**..*..*....*..*..*.....**..*.......*..*****..*...*..*..*.*.....*.**..*....**......**.*.....*****......*.*....**..*.**....*..*.*.*..*.*
.**.**.**..*.....*.*...*.*............*........**..*....*..........*.....*..*..**.**......*.*....*.*..*.*.......*...***.*....*.*....*..*....*........*
.*...**..****.*.*..*.*...........**.*.....**.*....*....*.....***.**.*.**.....*..*....**.*.....**.*...*...**...*.*...**.....*........*....*....**....*.
*.....*....***.**...**..*..*.**..*...**.....*.......*..*....*.*.............**..*..*..*.**..........*..*...*..*.**.*****..***.....***.***.....*..*..*.
.....*..**.*....*...**...........*....**..*..*......***...**..**.....*.*.*.*.*....*...*............**..*.......*.*.....*...*.*...*.*..........***...*.
*.......*..*......*.......**....*..*.*.*.**.*.*.*.**.**.....**..*......*..*......**..**...**.........**........*.......*..*....*.**...*.*...*.*...**..
..*..**...*.*.....*..*.*....*.*..*.....*...*........*.....**...*..*....**............*..*..*..**.*............***....*.......**........**..**.....*..*
*......**.....*...**...*.*....*.*.....*...*.......*.*.*..*....................*....*....*.*..*.*.....**..**..**.*..*.**.*.......**..**.....**......*..
...........*.**.........*...*..*.*.....*...**...............*...*.*......*...**......**......*...........*.***..*..*..*.....*...*...***..*..*...*.*...
*.*..*.......*..*.*...**..*...***..****..*..*.**.**....*....**.*....*.*..*....*............**...*.**.*.**....*...***.**..**......**.....*..*.....*..**
........*...*...*.*..*..*.....*.....*.......**.*...**.*.*.*.*****..***...**.*.*.*..**...**.*..***..**.....*.**.*.*.........*......**...*.....*.*.***.*
..*...*..*.....*..*...***...**.**........*........**....*...*.......**...*...**...*..**.*...........**..*....*.**...*..*..*.*.....*...*.*..*.......*.*
.*..........*...****.....***.**....*.*.*..*..*.*...*.*.......*....*...*....*....**.*..*.**.*.**......*..*..*.**....*..***...*....***.*.....*.*..*...*.
**..*................*****...*......***.*......**..**..*.**.**..*.*..*...**....*.......*.*...*..**.***...*.**..*.**.*.......***.****..........*.**....
.....**...*.*...***.*.*.**..*....***..**...*.*..**...*..****..**.*****....**.*...*................*..............*..*.***...........*....*...***.....*
.*.....*..**.**.*.*....*.*....**.***..*......*.*..*...*.*.*..**.**.*.*......***.....*.....*.......*.***.....*....*..**...*....*...*.*.*..***....*.*.*.
*........**....*..*..........*..*.*.*..*.*.***..*..*...**.*.**...*..*.*...**..*..**.*...*.....***.*..**...*.**.*..*.***.....**...*..*.*..*...........*
...*....***.*.*.....*...**........*...*.*....*...*.***......*.*..*...****..*..**........*..**.*.......*...****.....******..*...*.*....*.*.*......*...*
....**.......*.**....*..*...*.*.....*...*........**.*..*...*.*.***.**..*.......*..*.....*.....**..*.*...*.***...***......*.........**..*..*.*.....**..
....**.***.*..*...*..***.......*...**....*..*..*....*..*....*..*.....*......*......*...***.*..*.*..*..*...*..*..*.....*..***.......*..*......***.**...
....**..**.....*.*...**..*.*...*.**..*.....*..**..*.**.....**.**.........*..*..*.*...*...*.........**.*.....**..**......**...*...*...*........*.....*.
*...*.***.*.**....***...*....*.*..*.*...*............*...*.*......***.........*.*..*.*..***..........*...*.*..........*..*.**......*.**..*..*.*..***..
**.*..**.................***.****.......**.***.*...**..........****...*....*.*...*...........****......*....*..*.........*.*...*.**.......*...**..*.*.
*..*.*...*.*.**...........**.**...*.*...*...*...**.....*...*....**.**.....*..*..*..*.*....**..*..**.*.*.........*....**....*....*.....*....*.......**.
*.*.*.*..*..***.*...*.**.*..**..*..*.*.*.....*....*.*.*.****.....**..*.*..**.**.*......*.*.*.****.......***........*..*....*.*.*.....*..*..*....*.**..
.*..........**....**.*.*......*.**..*.....*.*.........*.***...*..*..*..**.*..***.*..........*...*.*.*****.****...*.........*....**.*......**.*....*..*
...***.*.**.....**.....*........*.*.**.*..**.**.......**..****..*...*.***......***.*....**..*..***.*****..*.*.....**.................*.*...*..*..**.*.
****....*.**.**.**.....***...*..***.*.*..*...***.*..*...*.........*.*....*.....*....**....*.*..*...*...*.......*......**....***.**.*...*..**...**.....
*.*...*..***.*.*.....*..*.*...*..*.*.**......*..*..**....*............*.*...**.**........**...*.......**...**.....**.*.*....****.*....*..**.*..*....*.
**......****.*.**.*..*..***....*...*****..**.***......**....*..*..*......**..*...*...*.........*..*........**..*.....*.*....*..**......*...*....***..*
....*.....*...*.....**........*..........**..**.*.*.*......*..***..*.**.....*.....*..**..***.*.*....**....*...*.....*....*.*****..*.**.....****.*.*...
**.......*....*....*....**....***.......*..*.**..*..*.*...*.......***...*...*........*.*.....**.....*..*.........**..**....*.........*............*..*
.....***..............*.....**...**.*.....**..*.**.*..**.........*..*....****....*....*..*..**....*.*.*......*.**.**..***..***..*.*...*.*..**..**.....
.......*.*.*..*...*.*.....*.**...*......*.*****.*.*...*..........*..*.............**..**......*....*..**.**..**.***.*.*.*.*.................***.*.....
.*........*..*.....**.**.*....**....**....**.*......*......*.*.*.*..*...*..*.*.**...**..***..*....*.....***..*..*...*.*..*....***...**..*.**...***....
.*.*....*.**.*.........*.*..*.**.*.**...*.......***..*.*.......*.........*.....**.**.**..***...*.*.......*..........*.**...*.*.**.*...*...*....**.....
.**..*.*..**..*.....*..*........*..**...*..........**..*****..*.*....**..*.*..**..*......*.**......*.......***..*.*..*.*.*.***....*......*.**.*.*..**.
*.*......****.....**.*....*.*.*..*......*...*.*.*....****..*......*...*.*.*...*..*..*...........*....**.....**..*.**..*.*..**....*.**.*..*.....*....*.
..***...***...*....*...*.**...........*.*....*.*........*..*.*...**.*..*..***.**..*......******.*....**...**...*....***...**.***...***.*...**.*....***
.**.*......**...*..*..*...*...*..**..*......*.....*.*...*..*.*...*...*...*.........*.*.**.**.*..*.**..*.**.....**......*....**.*....*.*.**..*.*.....**
.**......*....*.**..*..*.*....**.**.....**..*......*.......**.*..*..***.*.....****..**....*...*.....*.*....*.*..*.*.*.*......***..*.*.*..*..***.***...
**....*.*....**..*...*..**.*..**......****...**..*.**.*....*...*.*..*.*.*..**.*.......**...**.*..*.......*...*....*....**..*........*..**.*.*..*...**.
*.....*.....*...*.*..*........*....*..**...*..........*....*.*....*.*.*......***.*..*.**..*....*......*...*.**..........*....*..**.***.....**...*..***
....*..*..*..*.**...*.*.*..*.....*.......*....*..*******.*.........**...*......*.**..*.*....*...******...........*..**....*..*...***.*..*....*...*....
.*..*....***......**.......**.*.*........**..*.**......*.*..**......*..**..*.....**.***..*..*..*.*......*.****..**...*.....*.*..*..*.......*..*.**...*
.*..*..*.**.*...*****.....*...*...**...*..*.***..*......*......*.**.***.*....*****.*.**.*..*.....**..*....*.*.*.....*.*...*..*..*.........*******.**..
*...*..*..*....*..**..........***....***..*..**...*..***.......*.......*.....**.*...*...*..*...**..***.*.....*.**..*..*.**..*......*..***.*........*.*
*....*...*........*..........*.*....*...*..**.*....*.*.*...*.*.......**..**.*.**.*......*....**.*...*.*.*.*.*..*.......***.*..***...*.*...***....**...
..*.*...*...*.**..*......**.*..***..*..*..*..*.....**...*....*.*....*.....*.*.*.....*..*.......**.......*.*.....*****.**....*.......**...*.*.**..*..*.
..*...*..*.*.....*..*...**....*.**.....*..*..*..*.....*.......*....***.***......**.****...**...*.*...**....*.....**.....*..*....*.**..*..*.*..*.**..**
**.*..*...*...*..*.**.....*.*.......*...*.*......**..*.***.....**.....*.*......*..*.**.......**.....***.*.....***....*.*..*...*..*...**..**...**....**
.....***..*...*.**.*.......**....*..*..**.**.....*...*.*..*...*.*..**..**.....***.**..*................**.*..**..***..*..*.*....*.*....**......*.***..
......****....*.***.*.*........*.*...*..**...*......**..**.**......**....*...**.*.**...*..*.*.........*.......****.............*....**.*...*.....**...
**.*.....*..*.**.**.*.*.*....*...........*......*.*....*......****..*...*..*..*.*.*.....*....*.........*...*.**.*....*...*..*.**.....*.........*...***
.**.*.****...**.*.**..*..***..***.***....*....*.**...****.*..*...**.*...*.....*.**.*.***.*..*.**....**.**......*......*...**.*.**.*..*.**..*.......*..
.*.***..*.*..***..*...*.**.*.....*....*.*...........*.*..*.*...**........**.*....*.**..*...***...**........*....*....*....*.....***..**...*.....*..*.*
***.*.*..*...*.*...*.*.*........**.*....**...*.*.....*....**.*.*.*...**....**..*...*.....*.**..*.....*........**..*.*....*.*...***..........*.*.....*.
..*...*..*...*.**.......*.*.*.***..*..**..*.*....**....*......*.....*..*.**.....*..**.*...*.**..*.*.......*.**.**..**..........*...**......*...*...*.*
.*..*..*.*.*.*.*.*......*...**.*.***.........*...*.*.*.*.***......*.*...*.**......*..***.*.**..*.....*...*.**.......***.*.**.*...*..*.........*.....*.
*...*........*.*.***.........*...*...*****..*....*....*...*....*....*.*...*.*......**.......*.*.*...*...*.*.......*.....*.....*..*..*.*..*****....***.
...***.*.*...*....*.*.*.....*.*......*.*.*......*......*..*......*.*..*............****.....***..*...**.***...**.....**.***.*.......*.*.*..****...*..*
*...*..**..........*..........*..........*.*.*.....***...**.***.*.*.**.**.*.*...***.*.*.*..*............***.*..*.....*.**.*..*.*........*......*.*..*.
...*...**.*.......**...*.........**..**.*..*...*....*..*.*...*....*..............*..**...*.**............*.**.....*.......*......*..*....*.......*.*.*
*....*.*.....*...**.....**..***.......*.......*...*****.*.*..*.......*..*..**.**...**...**.....*..........**..***..*..*..**..*.**.....*.*....**...**.*
****.*..*..***...**.........*.....*.*...**.**.....*****.*...*..........*..*.**.......*....*...*...*....**.....**....****.*.*...*..*...**......**....**
......*.......*........*.***...*****......*.***....*....*****.*.........**...*....*.*.*....****.****.*..*.*...*.*.......*.....*.*..*..**....*.*.*...**
...**..***....*.*....*...*....*...*.......*.....*....*..****...**.*.......*...*.*...***.*.*.*.*...*..**..*..*.........*..**.*...*.........*..**.......
.....*....*.......*....*......*........*.*.....**.......**.*....*.*........****.......*....*...*...*.**.**....****.*..........*.*.....***........*...*
.*..****..*......*...*..***..*....**..*.....*.**..**.*......*..*......***...*...*..*.....*...*...*..*.*...**.....**..**....*...*..*...*.**.**......*.*
....**.......*..*......*.**.*...*........**..*.***..**...*..*....**.........*.*..***...***...*...*....****....*.*...*.*..*..*..*..*....*.***.*...*....
..*..*........*.....**.*..*..**..***.*...*......*.*..*.**..*.*..*...**.....*.*........*.****..*..*.*.*...............*......*.*......*......*.......**
**...*.**.*.....*......*.*..*..**....**...**...*..........*..*..***..*.*...*.....*......*..........*.*..*.**.*...*......*.*.*.....*...**.*...*.*..*...
...*..**...*...........*....*.*........*..*....***.**.*.*.....*....*.**.*....*.*...*.*.*..*..........*....*..*.***.*.*..**.*.*...*.*...**.*........*.*
...**...*..***....*.**......*.*....**..*..*..**.*.***.*..**....*.....*.*.*.....*.**.....*.***.*..**....*.*****.*......***.....*.*.**.......*......**..
.........*..*......*.*...*......*..**...*.*****....*.*.......*.*.*.*..*....*......*...*....*.**..*..........**.......***........**..*..*......**..***.
.*.*..*.....*.**...*.*......**.*.....***....*.....**....****.........**..*..**.*...*.**.....**.*..*...**......***..*.*..*......*......*.****........*.
...*..*.........*.......*.*.......*...*.........*.*..**.*.*.***..*...*.........*..**...**....*..**.***..**.*....*...*.*....*.*..*..***..*..*...*....**
*.***...**....**.*.*****..*.....*.*..*..*......*......*....*...**..*...*.*....***..*..*.**...**..***.***.*....**.******..*......*....**.*.....*.*.*.*.
.**.*...***.***.......**......**..***..**.....*.........**.*....*.*....*.*..*...**.........***.....*..*.*.**....*.*..*.*...***.*..............**.*..*.
...*.*.*.***....**..**.*.*.*...*****..*....*........*..*.....*.*.**......*..*...****...**...**.*....**.......**.*....**........*....*.**..*..*.*......
*..........**..*..****.......**.....*.....**..**...........**.*..***....*...**..*.....*.*..........*.**......*.*....*..*.....*....*.*........*.*.*....
**.*......*...**.*..***....**.*.......**....**.*.......*....*......*.**..*....*....*....*.......*.......*...**..**.**.***..**..*..........*.*...*.*...
.*.........*..*.*.......*...***...*.**..*.*..*.*.....**.***.....**......*...*.**...*.**..*.....**...*..*..*.**..*.......*....*....**.*...*..*.**......
...*.*....*.*.......*.....*...*...*.**..*.*.**....***........**..***.......*............*...*..****......**.****..*....*.*.*..**..*.*..........*.*..*.
.**.*..*........**.....***.*...*....*..........*..*....*..*....**..*..*.*...*........*..*..*...***.***.......*.....*..*.*..*....*..*...***....**.*....
.*...*..**.*.*.*.*.*........*.*..**...**.....*.**...*......**.........*..*.***.***.*.****...*...*......**......***..*.....*..****..**.......**..**....
..*....*....**.*..*...****.....*....*.*.*.*....*......**...*.....*.****.*...*..****.......*........*.***......***.*.*...**..*.*.*.*...**.......****...
..*........*.**....**..*.*.**...*....*........**...*.....*..*....*.**...*.**.**...*.....**...*....*..***......*.....**.......*......**.**..*..*.......
......*...**.*..**.***....*.*****.*.**.*...*.**...*....*.....*..*..*.**.....*...*....**.*....*.*.*.**.*...*..*....**..*...****..**....*.*...*....***..
........*.*.*..***..*.......**......*......*.*........*.......**..*..**...*.*.*..*..****...*.**..*......*.**..*.....*.*****.*.*.......***......**....*
*...*..*....*.**........*.**..*.*....**.......***.*....**.*..*..*..*.*...**..*.*.*...**.......*....*...*....*.*****.....**.*..*.*.**.*........****..*.
....*.........*...**....*..*.**....*.*..*.**.*.*...*.*...*.*..***.........**.*.****.*.*........**....*.***....*.*...***....**.....*.*.*..*...***.*....
*.**.*.*.*.*.*....***..*..*...*.*.....*..***.....*.......*.....**.*...**........*..........*.........***...*..*.*.........*..*.*....***....**......*..
*.*...*.**....*.**..****.*....*.....***.*..*......*.*..............**.*....*.*.............**.*...*..**...*......................*....**.......*****.*
..**.*..*.*.*....***..........**.*.**..........**...*...*..*.***.***.*.**....*.*.**..*...**.......*....*..*.......*.......*....*.**.*.*.**.****..*.***
.*.*.......**...*.*.*..........*..***.*....*..*..*..***..***..****.*........*......*.*.*.......*...*......**...*.*..**.*..**.....*...*....*..*..**....
.*..**....*.*.*..*.*.*.*......**.**..**.*..**.....**..*......**.....**..............*...*****....*..*....*..........*.*.*.....*..*.*.*.....*....*.....
*...*.**.....****.*......**...*........*....*.*...*...*...**...****..*.*...**.**..***......*..***..*.....*.....***..........*...*..*.*..*.**.*.**...*.
........*.***..*......*...*..*..*........*.*...........***..**.**.**...*.*....*...**...*.*...*......*.*....****.*................*....*.*.*.*..**.....
.**...**....*.**.*..*....*.***.*.*.*.......*...*.*...*...**.*.***....*.*.*...*..**..*......**....*..*......*.*..*.....*.**...*..*...*.*..***.*..*.....
..*..*.....***..**...*.*..**.*.**..*.**..*.*....*......**..*.**..*.*.**.....*.*.....................*.....*...*.....*..*..**....***....*..*.......*...
..**.**...*.**.*.*...*..*.*.*...*............***......*..*..***.*..*......*.*..**.**.*...**....***....*.**...*..*.....*.........*...**.**...**...**.*.
.***.....*.****.*....*.**....**.*....*...**....**....*..*......**.....*..........*......*...*.*...***.***.**.**....***.....*..***......*........*.....
..*..*..*....*..*...*.....*............**.....***.**......*...*.*...*.*..........**..**........*..*...*.*.....**....***.....*...**..*.......**..***...
*..*...***.....***.*..*...*..**.**.*...*.*..*.....**.....*..***.***.*..*..*..*.***...*.***.*.*......*.*....*.*******..**.........*.*.......*.**...*.*.
****.**..*....*.**....*...*..*.**.........*..*...*.***.***.*...*.*.**........*.....*.*.**.*...*........****.....*.*..*.*.*.*...*....*..*......*.***.*.
*..*.....*.**.....*............*.*...*.*.*......**.....*......*.*.....*...**..*.....****....*.*.........**................**...*..**.****.*.**.**..*..
.*...*.*..****.*.**.******..**..*.....***........*****.***.*...***.*.....**.....*.......**..*.*........*.*..*....*******....***...**....**...........*
.*........**.***...*..*.*...**.*.*..*..**.........*......*...........*..*.***.*.**.*..***.*..***...**..*..**....*......*....*....*....*.*......*......
..*..*.*.....*.*..**.*..**.........**.*******.***..**.*.*.....***....*.....*....*.*.**....*...*.***..*.*..*......****....*....*...**.**.*.**.*.**....*
.*.**......**......*.......*..*..........*.*.......***....*.....*.*..***..*.**...*...**..*..*...***...***....**.....*....*.**.***.***.....*.......*...
.*....*..*..**..*....***......*.*.*..*..**..*....*.....**..**.*.....*..*..*.**.*...*..*...*.*.*.*.....***..*.....*.**..*....*..................*..*...
*..**....*.***..***.*...*****..***....**..*..*.*.*......**.*.*.*.*.***.*..**....*.*.**...*..........**.*....**.................*.*.*..........*....*.*
*..**...*...*.*.*.*.....*...*.**...**...*...*..*..***.....*....*....*........*......*.*.*.......*.**...**.**..*...*....*.......*****..*..*.*..**.***.*
**.*...*.**..*.*.**....*..*.***.....**.**..*..*.*.***.....*.*.........*....*..*..*.*....*.*.*.......*...*........*...*....*.*.*..**..**.**...*...*....
...**..........**....*...............*...***..*...****...****....*.*..*..........*..*....******.*...**....*...***.*.*...........*...*.....*.**......**
*...*......*..***...*...**.**....*.....*...*...*.*.*...*..*...*...*.*.*.*....*....*...*....*.**.....*...*.....*.*.***.........*....**..*..**....*.....
.*...*..*..*.**......**.....*..*.*..*.**....**...*.*...**....**...*..*.**..***.*...*..*.**.....****.***..*..*..**.***.**...**...........**.....**.*..*
..*.........****.*...*.*..*.....***...*..*.*.*..**...**......*..***.....*.*.*..*.*..*.*......****..*...*.*.....**.......*....*..*.....*..*..*.**..**..
...*...*........***.*.*....*..*..***....*.*...*..*...**..**..............*.***..*...........*........*...*....*..........*.*..*.*...........**........
.*...*........**......*....*.*..**.*..*****.*....*..*...*....*...........*........*....*.**.....*.*....*.*...***.**...*....*...*................*.....
..*.*...*...***.*...*.**...*..*......*..*...*.**..*..**.*.***........*.*......*.*.*.*.**...*..*.....*.*****.**.**.....*..........***.......*.**...*.*.
*....**........*....***....*..........**.*.*..**.*.*..*.....*.**.......*..*.....*.***...*..*....*.....*...*.*...*....***...*..*....******.*...*..*..*.
**.**.......*..*..*.*...*..*****...**.*.....*....*.*..*.*...........*.....*.*...........**...*.*..*.........*.**....***.*......**....**.....**..*..*..
.....**...*.........**....*...*...*......*.*....*....*..*...**....*..*.....**...*..*..*....*.....*.*....*....*..*.**.....*...*.*......**.*..*.....*..*
*.....*.****......*..............*.*.......**.*..***........*..****...**.**.*.......*..*...*..*..*.**.**.*****.......*...*...*...*...*......*.*......*
***.*....*..*...*...*..*...*.***.....*.**.*....*..*......**......*.......*.*.*.*....*..***..*.*..**.*..**..*.....*.*.*..**....*......**.***....**..*.*
*.**...*..*......*..**.**.**...*.*............*..***.*.*....*.*...........*.*..**...*.....**..*....*...*..*....*.*...**...**..*.........*.***.*.......
*.........**.*...*......*.....*....*..**...*...*....*...**.*.*.....*.*....*..*.*...*..*.*..*.....**..*.*.*..*....***....**..*....*.......**.*...***..*
