150-IO
------------I--I---I-----------I------I-----I--I-----I----I-I--------II---IIII-----I----I--------II-I-----------I--------II--I--I-I-------II--I-------
--I---III---I-----I----------II---------------I---I-I-------I--------------I--------I---II--I-----I---------------------------I--II-III-------I---I---
--I--------I--I------I-----------I-I-I--I-I--I-I--I---II----------I--I---II-------I-------------------I--------II-------II--I-------III-----I---------
-------I----I-II----------------I--I----------I----I---------I-----I-I-I-I--------------II-I-I-I--------I--------I--I-I-II-------I-------I---I-I---I--
I-----II--I------------------II--I------I--------I----I---I-I---I---------I------------I---II---I------------I--I-I-------I--II------II-I--II---I--I--
-II----I--------II----------------------------------I-------------I------II----I----I-I---I---I------I---------I--I---I------II-----II-------I----I---
-I---I--------I---I------I---I-I-I----I----I-----------I-----I-I------------------------I----------II-------I----I-I------------------I-----I--------I
I--I---II--I---III-I---I----I--I--------------II-------I---I----------------III-----II-----I----------------I-I--------I---I---II---II-------------II-
--IIII--II----I------------------------I---I----------------------I----I-I--------I-I-------I--------I---I-I---I----------I----I---I---------I----II--
---II-III---II----I-----II--------I-----I-----------I---------------------II--I----I---II-I--------------I-I-I-II-----------I--I--I-I---I---I---------
-I----I--I--I--------------II-I-II-----I-I--I------I----I------I---II--------I--I-------I-----I----I----------II---------I----III-----I---------I-----
-----I-------IIII------II--II----II-----I--I-I------I-----I---I--I---------I----I--I-I------------I-I-------I-----I--I--I---I------I----II--I-II-II-I-
---I---I--I-I-II--I-I------------I----------------I-----------I-----------I-I---II-I---------------III--I--------I-I------I---I----I----I-II-------I--
---I-I---II-----I----I------------II-II--I---I----I------IIII---------III-------I--------------------------I-I---I-----I-I----I------------II---II----
I-----II----I---I-I-I----I--------------------I---I----I-II------I------I-I--I------I--I-----I------I-----I-I-I--I------II------I-I--------I------I---
-----I----I---------------I----I---------I--I---I---------------------I-II-------I---II------------I-I---I--I--------------I-I--I------------I-III---I
------II-II------I--I-----I-----------I-I-I----III-I--I--I----II-------I-III-I--II----I-----I-------II-II---I--I----II--I--------I---------I---------I
---------I--I---------I-----I---II-----I---II-II----I--I-------------------I-I--I--------I-I--I--I-----I--I--I--------------I--II-I------I------------
-I---I--III------I----I-II----II---II-------I--I---I-I---I-I-----I-I--------III-I-------II---------I--IIII----------I-I----------I--------------I--I--
-----I--------I--I-------------I---------I---I-II--------I-------I-I-----------------------------I-------------------I---II-------I-------------I----I
--------I--I--------III---------II---I---I--I----I-I--I-I--I-------I---I--I----I--I----------I------I----I------I------I--I----I------I--I---I--I-I---
II------------II---------II--I--I-----------------------I---I-I-------------II-I-------I-I----I-II---I--------I----I---II--II-----------I-I-I---I-----
----------------II--II---I---I--------I-I--I--I--II---I-------II----I-------I-II-----I-I-I--I--I------II-I-I-I----------I-I------I--I-II--I------III--
---------III-------I-------------------I--II-------I---I-----I--I----------I----I---I-------I-I-I----I----------I-----I----I---------I---------I------
I-I--I-II----I--III-II----I-----I---II-I---I-I---------------I----------II-I----III--I-------I----I-II-----I--------------------I----I---I-----I------
-------I-I-----I-----I--I--I--I---I-----------I---I-II---------I---I-------------------I---I-----I-------I--------------I------I-I----II-I--I--------I
---I-----I------I----I--I-----------------I--I--I----------I------I---II---II-I------------------I-------I------I-------I--I--I-------------II-------I
----I---II----II-I----I-I----I---I----------------III--I------I-I--I-----I----II----------------I------------I-I-I--IIII-I---I--I-I-----I-II---I-I-II-
II-----------------I---I------I----I-I----I-I---II-I----I-I-----------II--------I-----I---I--I----I---I-----------I-------I-----I---I-I------II----I--
-----I--------I---------------------------I-I------I-------I---------I----------II----I------I------------I----------I--I---I---II------------I--II---
-I------I-----I-----------I---II----I--I--I--------I-I---II-I-------I-----------I---I---II--I---II---------I-I-------I-----------I-----I----I-I----I--
--I------I-II-------II-II---II--I-I-I-I-----I----I---------I--II--I-------II--I---I----I-------------I---I----I---II---I----I-----I--I------I-I----I-I
--I--------I-I----------I---I-------------II-I-I--------I---I-------I-I---I---II-------I------------I-----I-I---I-------------------------I---I-------
--II-I---I-I---I--I-I----I--I--I------------I---------I-------------------------I-I----I-I-I-I---------I-I------I----I----I--II-III---II----I---------
I---I-------------------I---I---II-I------I----------I-I-I----I-----II---I-I------------------------------I-------I--------II------------II---I-I-I--I
-----------------I------------I--------------------I-I------I--I--I-----III--------I--I-------------I----I----------I-I---I---I-------I--I---I---I-I--
I-II--------II-II-I---II--------I--I-I---I--I---I----I-II--I-------I----------I--I--------I--I--------I--I--II-----------I----I---I-I-I-II-I----------
--I--------I-----I------I---I----I--I---------I-II--------I--I--II----I----II-----IIII----------I--I-I-I---I-------I-I------I---------II--I----I--I---
-------I--II--I---I---II-I-I----I-I------I---I-II------I---II----------I----I---------------I-----II-------I--------I----------------II---II-----I----
--I---I-------I--I-I---------------I------I-I--------I----I-----I-----II-----II------I-I-I----I--I-------I--I-III-I---I--I-I-I-------I---I---II-------
--I-----I-----I---------I---I--I-I---------I------I----I------------------------------II-III-----I-I------I------------------I------I---------I-------
II---I---II--III---II----I--------------I---II----I----II-I-------I--------I----I-----------------I----I----I-I-I-----I------I-I--II--I-I-----------II
---II-I-----I------I-I----I---------I-I--I----I----I--II-I-----I-II--I--I---I--III-II----I----I---I--------I----II---III----I---I-I--I-I-----I--I-I---
----I----I-II---II-----II---------I-I----I-II-I---I------I-I-I-I--I----I-II-I---I-----II--I-I---I---------I-----II-II-I-----------II-----I-------IIII-
---I--I-I-------------I----II--I--I---I-----I------I-----I-I--------------II--I-III--I------I------I--I----I--I--------------III-I---------I----I-----
--I--I--I---I---I------------------II--I----I---I-I-------I-I-I------------I-I--I----I--I-I---I------I---------I-------I-----------------I----I-----II
I-------------------II-----I---------I------I---------I--------II--I------I--I------------II-----------I----I-III----III--II-I------------------I-----
I-I--I-III------I------------I-I-------I-II----I----I---I--I-----I----I-IIII-------I--------I----I---I--------I-----I--I----I----I----I--I-I--------I-
---I--I--------I---I-----I-----I--I------II--------II-------I---I-----I-----I----I--I--I----I----------I--I-I---I---II----IIII-------I---I-I---I-----I
------------------I------------I--I-------I--I-II-----I----I--------I----I-----I------------I-I---------------I---I-----I--I-------I----------I-------
---------I-----I-I------------I------I-I-----I-----I----------II---I------I-----I--I-----I-I--I--I------I--------I------II-----I---I-----I---I-III-I--
I-I--------I-----I---I--I--I---------------I-------I-----I-II---I--I-----II--II---I---------I----------I----II-III-I-----------I--I-----------II-----I
---I---I-------I--------II--I-I--I----II-----II--------I--I-----I-I--I-----II-II--I--II---II--I--------I------------I-I----I----I----I---I-I------I---
I---I------I-------II--------------I-I----------------I----I-------I-----------I------I----------------I-------------I-------I---I-I-----I---I----II--
----------II---------I-I------------I-----I-------I-------II-----I--I-I---I-I-----I-----------IIIII-I----I-----I----III------I--I-I----III--I--II---I-
-----I-----I-I-II-III--I---I------I------I---I-----I--------I-I----I-I---I---I-I---------I-----I--III-----I-------------I--------I-I------------------
III--I---I--I------I------------------------I-------IIII--------I------I-------I-------I-------------II---------I-I--I----------I-----I--------III---I
--------I-----------II-------I---------I-----II--I--I---I--------I-----------------II--I--------II--I-----------I---I--I---------I-------------I----I-
--I-I--II-------I-I-------------I---------I------I---I--I-I----I-I-I-------I---I---I-----I--------I-----I-----I-------I------I----I----III-------I---I
I-II-----II----------I-I---I-----------I----I-I---I---I-----IIIII---I---------------------I-----------------II---I----II-I---I------I--------------I--
-II------I------II--I-I---I--------------II-I---I----------I----I---I--I--I--I-II-------I--I----I---II---I------------------II--I---------------------
--I-I-----I----I-I----------------II-------I-------I---I--I-IIII------III-I------I---------------I-I-----------I--I--------I-III-----II--I-----------I
--I-----------------II---I-I---I------I-I--I---I----II--I-I-----I---II-I--I-----I-I--I--------I-I----I---------I----------I----I-----I--I------I--I--I
-I------I------I---II--I-----I----------II----------------II-I-------I--I-----I--I-I------------I---------I----II---I-------II--II-------I--I---I----I
----I-------I---III----I-----I-----I--I--I----------II--------I-----I-I--I------------------I-I--------I----I---I--I--------I-I-----I--I---I-----I--I-
-I---I----I-----I------I-I-----I----II-----I----I----I-----------------I---I--I-----------------I----I---I-------I---II----------I---------I-----III--
--I--II----------I-I-----II---II----I------I-----------II--I--I--------------------I-----I------I--------I--I-----I--I---III-II----II--I------I---I--I
I-----I------------I-I-----I--------------------I----------I-----II---II-----II-III-II---I---II---------I--I----II-----I--------------I-II-----I--I--I
-III--I-----I-II-----I------I--I----------I------I----------I----I-----I----------III--I----I-----I------I-------II-I--I-----------I---I--------I---I-
-------I--------II-I-I-----------I----------------II------I--I--I-I----I-----------II-------II-----II----I---------------I-I-------------------II-----
----I----------I------I-II---I---I-----I----I----I-----------I--I--I--I---III-----I-----I--I----I----I--------II-----III---------II-I-----------------
---II--I------I---I---I-------------------I---I---I-------I--------II-------I----I-I---------II------------I------------I------------------I----------
I-------I----I----I--------------I-I-II----I--II-----------I----II---I-I-I------I---I-----I---III-----I-------I----I-----------------------I-------I--
----I-I--------I------II-------I---------I-------I--I-------I-----I---I---I--I-I-I----------------I------------I---------------I--------I------I-I----
----I--------III------------II--I--I---I--I------I--I--II----------I---------------III--I--I-------I----II-I--I-I-I-I-------I---II----I----I----------
--II--I---I---I------I----I--------I---I-I-----------------I-------I--------------II------I---I-I------------II---II----I----------I-----I--I---------
------------I---------I----------I---I--I-III----I---I-------I---I------I---II----I---------II--I-I-II---II---------------IIIII-----------------------
-----I-------------II-III--I-I---I----I-----I-------I---I---I--I-----------I---I------I-----I-I-------III-II-I--------I------I---I------------I------I
----------II-------I--I------I-------I----------I---I-II------------------I------I-----------------I------------------I----I---I-II-----------I--I--II
-------------I--I-------I----II--------I--II---I-I----------I------I-I--I-------I-----II--I--I--I--I-I-------I-I-----------I---I-I---I-----III-I-I----
-----I-------I-------IIII---I--------I------I--------------II---I--I-IIII-----------II-----I--I-----------I---I--I--III-------I-----II----------------
--I---I---------I--I-III--I----------I--------I-------I-----I-------I--------I--I-------II--I--I-----I--I-II--I---I-I--II-I----------II----I----------
--I--I-------I------I--------II-I----I-----------II-II----I-----------I---------I-I-I--III--I---I---I----II---I--I--I------IIII---------I---------IIII
----I-II--------I--I-----------I---I-II-----I--II--II-----I-----I-----------I-I-I-I--I----------I--I-I-I--II-I---I---I--I------II--------I------I-----
-I-I----------I-I-----I-----------------I----II-II------------II-II---I-I---I---I--I---I----I----------------I--------------I--I------I---I---I-II---I
--------I----I--------I---I-II------II------II------I-I--------I-I--II-II---I----I----------I-I-----I--------I-III-I------I------I-----I-II--I--------
--I--I--I------I---I------------I--------------III---II--II----I----I----II-------I---------I-I--------I--II-------I--------II-I-I------------I------I
--I--I--II--------I----III-I---I------I-------------I--I---I---II------II---I----I---------I--I-----------II-II-----I-----I----I---I------I-----------
I-----I---------------------I-------------------I-----------I-------------I--------I--I------I-----II-II---I-I-----------I-I-----I--I----I--I---------
---------I--II--------I--I---I-------I-I-----I-------------I-I-------I-------------------I--------II--I--I-----I--------I-------------II-I-I------I---
--I-I-I-----III---I-----------------II---I-----I-I-I-I-I-I----II----I---------I----------II--------I-I--I-I--I--I-----I-I-------I----I--I-I-----------
--I-I---II---I--I--I----I-------I------------------I-II------I---------------I----I----II--I-----I--I-----I---------------I--I-----I---I----I---------
--I---I--I---I----I---I--------I------I-------I-I-I----I----I-II----------I-I--------III-----I-I-I-II-------I-----I-II-I-II---I--------I-II-----------
----II--------I-I---II-----I------I------II---II--------I-I----I-III-III-----I---I-I--I-I------I-I--------------II---I----------I-I-I-I---I----I-I-I-I
I-I-I--I----I--I--II------I-I---------I----II---I-I--I---I--II-II--I------I----------II----------------I--------I--II-I--------I-------------I-----I--
-I---II-I---I--I-----I---II------I----------I-----------I--II-------I-IIII----I-------I---------------II-----I---I----I---II--------II-I--I------I---I
I---II---I--I----I----------I--I--I--I----I--I----------I--------I-II--I-I---II--------------------I---------------I--II---I----I--------III--I--I----
---------I--I-----------I----------I--------I----I-------I-----I-I------------II------I-----II---I--II--III-I--------I-------------I--I-----I---I----I
---II----III----------IIII---I--I-------I-I-------I----------II---I-------I---II-I-I---I---I---I---I----II-II--I----I--I-----I----------II------------
---I-------I--I--I----I-----------I-I----I-III---I--II-I----------I----I----------I------------I---------I-----I-----I--------------I-I--I--I---I--I--
----------------I-------I------------I-------I--I---III--I-------------I---I-------III-II---I--I------I-----I-I--II---II-I--II--I-----------I-----II-I
-I---I------------I-III-I--II--I--I------I-I-I-II---I----I--III------------I--------------I----------------I-I----------II-I-----------I--I-----I-----
I--------I---------I-------I-I---------I--------------I----I---II--I---I-----------------I------I-----I---I--I--I-----II---I-I---I----I-----I---I-----
--I---------------------I-----I---I--I----I---I--II--I-------I----I---I-I-I---I--I-I---I--I---I--------III-------------II-----II------I------I-----III
--I---I--I----I------------------I----II----------I--I------I-I----I----I---II--II----I--------I------I-I--II--I-----I-II-------I---I------I----II----
-I---------II-I--------II----I------I----------------I-------I-I------I--I-I-----I--I-I-II-III--I-----------I-----------------I-I-------I-------------
I--I------II--I--------I-I---------------II--------I-----I-----------I-I-----II--------II-------------I-I-I--II--------II----I----I-----II---------I--
--I-------I---II--I-------I--I----I-----I--I--I--I------------II---I------I--I----II-----II---I----I---I----I-I----I------I-----I------II--I----------
------------I--------II----II-II--I-----I-I-------------I---I-I------------II---I----------I-------III-I--I-----I--I------------II---I------------I-I-
--I--I-I-----------------------------------I-----I-------------I----------I--I-------------------I---I---------I---I-IIII-I---I---I-----------I--I----
I----I--I-----I-I----I---I---I--I--------I-I--I-I-I-I------II----I-----I-------I-----I-----------I---------------------I-----I----II------------------
-I-------I-II---I-I-----------------I----I-I--I-II----------------I----I-II------I--I-----I-----I-----I-------I--I---------------I------I-----I--I-I--
I-II---I-I---II-----I-----I-------------I---I-I-I-------------I--I-I---------I------I-----I--------I-I---I---I-III------II--II---I---I---I---I--I--I--
----------------I-----II----I----I---II---------I----I-I--II------I--I--------I-I-----IIII-I----II--------I--I---------------I----I--I-----I------II-I
---------I----I--II-II--------I--II-II-------I---------------I-----------II---I----II-------I----------------------------------I--I-------I--I-II-----
-I-I-I---I-I-------II--II-I-------I--I-II----III-I----I-I----III-I--I-----I----I--I--------I--I----------------I----I-I------I-----------I------------
-------III--II-------I---------I-II-I----------------III--II--I-----------I----I---II-----I---I-------------I-I-II-----I-II-----I-I---------I-I-------
------I-I---------I-------III---------I-------I----II---------I----I--I------I-------I-I-----I-------I--I------I--------II--I-II-----I----II-----I-I--
--I--I-----I-I------I---------II-------I---I--I-II----I-----I-I-----I----II--I-----I-----I----I------II-------------------II----I---I--I-I--------II--
-I-----I-I-----I---------------I--I-I---I--------------III----I--I-I---I-----------I-I-----I-I-I---------------I-I--I--III-II--------II--I------------
--III------------------------II----------I-----III--------I------------I------I-------I--------I--I----I-I------I------I-II----I-I-I----I----I--I-----
-I---I-I-----I--I--------I---I-I-----I---I------I--------I---I-II-----II---IIII-----I----------------I------I-I-I------------------------I--II--I---I-
-------------------I-I-------------------I-----III------I-I-I------I---I-I-----I------I-I--I-----I--I---I-II-I----I---I-II-I--IIII--I--I--I----I-----I
--III--II--------I------II------I-I-----I---II--I-------II-------I-I------I---------I---I---------------------------II---II-I-II------I------I-I-I--I-
--I--I---------I-------I---I-I--I-I--------I---I------------------------II-----I-------I--I-I---I---I-I--II-I-I-----I-I--I-----I-I-II---I--II------I--
--II-I--------------I-----II------I-------------II----------II------------------II--III----III-----I---------------------IIII-I-----------I---------II
I---II-I----I---I-------------III----I----I-----------II----I------I--II---I-I--I--I-------I------------II-II----I---I---III----I------I-------I------
-I--------------------I---I----------------I--I-I--I---------I---I-------II-I-------II-I-----I-----I------I-I-----I-I-I-II-----I--I--------I----------
--I-------II---II---------I-I-------I-II-I-I---I-I-I-----I------------I-I-I----------II-II----I----I------------I-------I------------I-I-II----I-I----
I--------II-------I--------------I---------I-----------II-I--------II--I--I------I---II-----I-------I----------------I---I-------I-------------------I
--II--I---II-------III-I---I-----I-I-----I---III--I-I-----II----I-I------I----I-I--------I------I----I-----I-I-I-----I-I-I----IIII----I-------------II
----II----------------II-------------I-----------I-I----II----------------------------I--I---III------I--I-------I-II----------I----I-------------I-I-
II------I--I---------I---I----I-----------I--I-----------I------I--I---I-----I----I---I-----I-I--I---I-I-II----I--I-II----II----I-I-I---------I-I-I-I-
---I--I--II-I----I---I--------II---I-------------I-I------------I---I-I---I----I-I---I------I-I-I-----I-----------I--I-----I-----I--III---II------II--
I------I------------IIII-II--I---I--------I---I-II-----I----I----I--I---I----------------------I-I----III-I----I------II-I---------------II-I----I----
-----I-I--I--I----I-I-II-----------I---------I---------I-------II-------I----I---I------I-I----I-I-------I------I-----I-----------------I-I--I---I---I
I---------I---I---------I-I--IIIII-I-------I--I-------I-----I---I------------II----I-I------I---I-I---I-I--I-I------I--II------I------I--II---I----I--
----I---------------I-----III-I-----------I-----I--------I----I-----II---I--I---I----------II----I------I------------II-------I-------I--I-II-------I-
------------IIII-I--I--I----I--------I-I----II---I------I-I------II----------------I--------------II----I----II--II--III------------------I-----I-----
I--II---------------I--I----I----I-----I-----------II--------II--I---I--I------I---II---------------I-------I-I----I--------II-------I-III-------I----
-I--I--I---II--I---------------I--------I------------I--I---I-I--------I----------I---I--I--------I-----I--I--I-I---------II---I------I--------------I
---I----I-II------I--I-----I--------I--------------I---I--II------II-II--I-I---------I-I----I----I---II------------I--I---I--I----I--II-III----I----I-
I-II----I------I-II------I-I-I----II-I----II---I----------------I-III-----I-I-I---I---I------I--I------------I---I--I-I-I--------I--------I--I-----I--
---I------II-----II--II------II-I------I--------I--III----I-----I-III-------I----I------I------------I---------I--------------I-------I------I-----II-
-----I---I--II-I-I--II---I---I-I-I-I-I-II---I--I---I-----I--------------I----I-I---I-I---I-----I------------------------II---II------------I--III-----
---------I----II--I---I-------I---I--I----I---I------I---------II-I---I------I--I--II-II--------II-I-----II------------------I-----------------I--I---
I-----I--I-----II-I---I----II----I-I--------II-II---------I------II----I---I--I--------I-I--II--I--I----I-----------I-I-------------I--I--------------
-----I-------------I-------------II---I--------II-I--------I--I-I----I---------------II--------I-----I---I--------------I----------------II-----III---
-I---I----I-----II-I-III----------I--II--IIII---I-------I--II----I--II----I----I--I-I-----I-I---------------------I-------II---I-I---II----I-I--I---I-
---------------I-I----I-I--------------I------I-I--I---I------I----I----------II---I----II---I-I--------I---------------I--------------------I--------
